level 3
next_level assets/level_boss.map
next_level assets/level_2.map
map
# # L # # # # # -1
# 0 K 0 0 0 0 # -1
# 0 0 0 0 G 0 # -1
# 0 S 0 0 0 0 # -1
# 0 0 0 0 0 0 # -1
# 0 M 0 0 0 0 D -1
# # # # # # # # -2