level 1
next_level assets/randomLevel
map
# # L # # # # -1
# 0 0 0 0 K # -1
# 0 0 M 0 0 D -1
# 0 0 S 0 0 # -1
# 0 0 0 0 0 # -1
# # # # # # # -2
