boss level
next_level assets/level_1.map
next_level assets/level_1.map
map
# # # # # # # # -1
# 0 K 0 S 0 M # -1
# 0 0 0 0 0 0 L -1
# M 0 0 0 0 0 # -1
# 0 0 0 0 0 0 # -1
# 0 0 0 0 0 0 # -1
# 0 0 0 0 0 0 # -1
# 0 0 0 0 0 0 # -1
# # # L # # # # -2