level 4
next_level assets/level_goldRoom.map
map
# # # # # # # # # -1
# 0 0 0 S 0 0 M # -1
# 0 0 0 0 0 0 0 # -1
# M 0 0 0 0 0 0 # -1
# 0 0 0 0 0 0 0 # -1
# 0 0 0 0 0 X 0 # -1
# G 0 0 B 0 0 0 # -1
# 0 0 0 K 0 0 0 # -1
# # # # L # # # # -2