shop
next_level assets/level_2.map
map
# # # # L # # -1
# 0 0 0 0 K # -1
# 0 0 0 0 0 # -1
# S 0 0 0 0 # -1
# 0 0 0 0 0 # -1
# G 0 0 0 0 # -1
# # # # # # # -2