gold room
next_level assets/level_1.map
map
# # # # L # # # # -1
# 0 0 0 0 0 0 0 # -1
# 0 0 G K 0 G 0 # -1
# 0 G 0 0 0 0 0 # -1
# 0 0 0 0 0 0 0 # -1
# 0 0 0 S 0 0 0 # -1
# # # # # # # # # -2