level 2
next_level assets/level_3.map
map
# # # # L # # # # # # # -1
# G 0 0 G 0 0 0 0 M 0 # -1
# 0 0 0 0 0 K 0 0 0 0 # -1
# 0 S 0 0 0 0 0 0 G M # -1
# # # # # # # # # # # # -2